===MAP
###########
#.........#
#....o....#
####...####
...........
...........
...........
===ENTITY
.=floor
o=player
#=wall